***************************
*  * * * * * * * * * * * **
*             +          **
*                        **
*      * * * * * * * * * **
*      ***************** **
*      *               * **
*      **   *     *   ** **
*      *               * **
*      **   *     *   ** **
*      *               * **
*      **   *  +  *   ** **
*      *               * **
*      **   *     *   ** **
*      *               * **
*      **   *  +  *   ** **
*      *               * **
*      **             ** **
*      ********+******** **
*       ****         *** **
*  **** *            *** **
*  *    *              * **
*  *    *              * **
*  ******              * **
*                        **
***************************
