**************************
*  * * * * * * * * * * * *
*             +          *
*                        *
*      * * * * * * * * * *
*      ***************** *
*      *               * *
*      **   *     *   ** *
*      *               * *
*      **   *     *   ** *
*      *               * *
*      **   *  +  *   ** *
*      *               * *
*      **   *     *   ** *
*      *               * *
*      **   *  +  *   ** *
*      *               * *
*      **             ** *
*      ********+******** *
*       ****         *** *
*  **** *            *** *
*  *    *              * *
*  *    *              * *
*  ******              * *
*                        *
**************************
