*************************
*                       *
*                       *
*                       *
*                       *
*                       *
*                       *
*                       *
*                       *
*                       *
*                       *
*                       *
*                       *
*                       *
*                       *
*                       *
*                       *
*                       *
*                       *
*                       *
*                       *
*                       *
*                       *
*                       *
************ ************
